eh	é,IN,79
facul	faculdade,IN,2 
ta	está,IN,1 estar,IN,1
to	estou,IN,1
vandalismooo	vandalismo,IN,5 
d	de,IN,11 
lindaaaa	linda,IN,1 
mt	muito,IN,16 
ne	né,IN,1 
bj	beijo,IN,1 
c	você,IN,1 se,IN,3 
vo	vou,IN,1
fzr	fazer,IN,2
mainha	mãe,IN,1 
neeem	nem,IN,1 
despiei	fui,IN,1  
aki	aqui,IN,6 
dakele	daquele,IN,1 
dindim	dinheiro,IN,1 
idemmmmmmmmmm	idem,IN,1 
jah	já,IN,2 
kd	cadê,IN,5 
lah	lá,IN,2 
quotando	#,IN,1 
soh	só,IN,7 
tah	tá,IN,6 está,IN,11 
ve	#,IN,1 
vlw	valeu,IN,3 
vlws	valeu,IN,1 
aminho	amo,IN,1 
carai	caralho,IN,2 
cm	com,IN,1 
cmg	comigo,IN,1 
moveei	#,IN,1 
ops	opa,IN,1 
bagui	bagulho,IN,1 
nois	nós,IN,8 #,IN,2 
vamo	#,IN,1 
po	#,IN,2 
guenta	aguenta,IN,1 
lindoooo	lindo,IN,1 
mamis	mamãe,IN,1 
sla	#,IN,1 
tl	timeline,IN,1 
coisica	#,IN,4 coisinha,IN,5 coisa,IN,5 
axei	achei,IN,1 
caraio	caralho,IN,3 
cel	celular,IN,1 
id	identificação,IN,1 
miga	amiga,IN,3 
migos	amigos,IN,2 
vei	velho,IN,4 #,IN,2 
zuarem	zombar,IN,1 
goooool	gol,IN,1 
mayyybbbbeeee	maybe,IN,1 
tuuu	tu,IN,1 
berrooooo	berro,IN,1 
brasuca	#,IN,1 
v	ver,IN,1 
kedi	cadê,IN,1 
mimmm	mim,IN,1 
tou	estou,IN,4 
history	#,IN,1 
juntooooo	junto,IN,1 
akilo	aquilo,IN,1 
blaster	ótima,IN,1 
cells	céus,IN,2 
dah	dá,IN,3 
karai	caralho,IN,1 
ki	que,IN,18 #,IN,1 
naum	não,IN,9 
queeeeeee	que,IN,1 
vazaaaaaaaaaaaa	vaza,IN,1 
vey	,IN,1 velho,IN,3 
pistolei	#,IN,1 
afrontaaaaaa	afronta,IN,1 
jacareeeeeee	jacaré,IN,1 
qro	quero,IN,2 
bandidaaaaaaaaaaaaaaa	bandida,IN,4 #,IN,1 
ah	#,IN,5 
pelamor	#,IN,1 
roupaaa	roupa,IN,1 
smp	sempre,IN,4 
axo	acho,IN,3 
demsss	demais,IN,3 
idd	#,IN,1 
magrin	magrinho,IN,1 
lags	atrasos,IN,1 
guriaa	guria,IN,1 
xulianaaaaaa	#,IN,1 
ae	aí,IN,5 #,IN,1 
mo	maior,IN,1 meu,IN,1 
akeles	aqueles,IN,1 
maaais	mas,IN,1 
diaa	dia,IN,1 
voteiiiiiiiii	votei,IN,1 
yesssssssss	yes,IN,1 
twetando	#,IN,1 
pow	#,IN,1 poxa,IN,1 pô,IN,1 
tds	todos,IN,1 
dispiei	dispistei,IN,1 desapareci,IN,1 saí,IN,1 
mozaumm	amorzão,IN,3 #,IN,1 amor,IN,1 
simmm	sim,IN,4 #,IN,1 
post	#,IN,1 
af	ave!,IN,1 aff,IN,1 
brincks	brincadeira,IN,1 
mow	maior,IN,1 
simm	sim,IN,2 
ahhh	ah,IN,2 
putz	poxa,IN,1 #,IN,1 
sacooooo	saco,IN,1 
trab	trabalhar,IN,1 
aaaaa	ah,IN,3 
massss	mas,IN,1 
queeeee	que,IN,1 
safadeeeeenha	safadinha,IN,1 
bora	vamos,IN,1 
etccccc	#,IN,1 
gnt	gente,IN,4 
mermo	#,IN,1 
ahn	ah,IN,1 
clichezudo	clichê,IN,1 
porreiro	bravo,IN,1 
alfinetante	desconfortante,IN,1 
bombar	arrasar,IN,1 
dislates	disparates,IN,1 
fofolete	fofa,IN,2 
pitacos	palpites,IN,1 
tadinha	coitada,IN,1 
eeee	e,IN,2 
eeeee	e,IN,1 
muuuuito	muito,IN,1 
terrona	terra,IN,1 
net	internet,IN,1 
botiquim	boteco,IN,1 
cargar	carregar,IN,1 
prob	problema,IN,1 
ain	ai,IN,1 
bommm	bom,IN,1 
miiiil	mil,IN,1 
oieeee	oi,IN,1 
pll	#,IN,1 
euu	eu,IN,2 
ngmmm	ninguém,IN,1 
nojoooo	nojo,IN,1 
todooo	todo,IN,1 
dnv	#,IN,1 
essaaa	essa,IN,1 
agoraaaaaaa	agora,IN,1 
ctz	certeza,IN,1 
euuu	eu,IN,2 
mane	mané,IN,1 
pprt	#,IN,1 
meo	meu,IN,1 
pfvr	#,IN,1 
descontrolaaaaaadaaaaa	descontrolada,IN,1 
rangar	comer,IN,1 
chuviscariiii	chuviscar,IN,1 
aviadado	afeminado,IN,1 
aindaa	ainda,IN,1 
amanhaa	amanhã,IN,1 
ambulanteee	ambulante,IN,1 
assistindoo	assistindo,IN,1 
namorandoo	namorando,IN,1 
naquelaa	naquela,IN,1 
piadaa	piada,IN,1 
taa	está,IN,1 
tamirees	tamires,IN,1 
vaii	vai,IN,1 
aaaahh	ah,IN,1 
aaaiii	ah,IN,1 
loka	louca,IN,1 
mds	#,IN,2 
aaaaaaaaa	ah,IN,1 
brinks	brincando,IN,1 #,IN,1 brincadeira,IN,1 
fdd	fudido,IN,1 
pesadooo	pesado,IN,1 
meldis	merda,IN,3 
tiira	tira,IN,1 
add	adicionar,IN,1 
emoji	#,IN,1 
comentouu	comentou,IN,1 
foii	foi,IN,1 
leuu	leu,IN,1 
onteeem	ontem,IN,1 
textooo	texto,IN,1 
tudoo	tudo,IN,3 
voceee	você,IN,1 #,IN,1 
hinoo	hino,IN,1 
mlk	moleque,IN,3 
olleh	olé,IN,1 
caraaaaaa	cara,IN,1 
assimmmmm	assim,IN,1 
mimir	dormir,IN,2 
geladaoooo	geladão,IN,1 
taria	estaria,IN,1 
treinooo	treino,IN,1 
tristeee	triste,IN,1 
iiiii	ih,IN,1 
zoa	brincadeira,IN,1 
fik	fica,IN,1 
qm	quem,IN,1 
comeer	comer,IN,1 
comeriaa	comeria,IN,1 
comidaa	comida,IN,1 
deuu	deu,IN,1 
falandoo	falando,IN,1 
naoo	não,IN,1 
tecooo	troço,IN,1 
vontadee	vontade,IN,1 
fluzao	fluzão,IN,1 
sorteee	sorte,IN,1 
pudinzinho	pudim,IN,1 
brigadinha	obrigada,IN,1 
votalhada	votação,IN,1 
xs	vezes,IN,1 
topper	top,IN,1 #,IN,1 
batolage	#,IN,2 
apagaaa	#,IN,1 
eo	eu,IN,1 
ultando	#,IN,1 
bue	muito,IN,1 
hm	um,IN,1 
troll	#,IN,1 
vsff	#,IN,1 
amooo	#,IN,1 amo,IN,1 
faaaar	#,IN,1 
gurizao	#,IN,1 
kabo	#,IN,1 
kiridan	#,IN,1 
lindona	#,IN,3 
okay	#,IN,1 
teeeee	#,IN,1 
bao	bom,IN,2 
gominhos	#,IN,1 
instapanico	#,IN,1 
superflor	#,IN,1 
zona	#,IN,1 
alimnetaaar	#,IN,1 
aniversariooo	#,IN,1 
clique	#,IN,2 
deliciinha	#,IN,1 
discretaa	#,IN,1 
emboraaaa	#,IN,1 
instaaa	#,IN,1 
ounnn	#,IN,1 
ousadoo	#,IN,1 
queriaa	#,IN,2 
bonitim	#,IN,1 
dimai	#,IN,1 
fude	#,IN,1 
crush	#,IN,2 
loucao	#,IN,1 
meme	#,IN,1 
piranhona	#,IN,1 
putiane	#,IN,1 
brincs	#,IN,1 brincadeira,IN,1 
tarjando	#,IN,1 
men	homem,IN,1 
credooo	#,IN,1 
mn	man,IN,1 
continuee	#,IN,1 
convocadaa	#,IN,1 
emagreceuu	#,IN,1 
gordaaa	#,IN,1 
kiloos	#,IN,1 
maezonaa	#,IN,1 
migaaa	#,IN,1 
podeee	#,IN,1 
regionaiis	#,IN,1 
aff	#,IN,1 
instasnaps	#,IN,1 
xau	tchau,IN,2 
coisica2	#,IN,1 
scrock	#,IN,1 
aaah	#,IN,1 
crushs	#,IN,1 
muie	mulher,IN,1 
caprichete	#,IN,1 
caraia	#,IN,1 
flopar	#,IN,1 
juntaro	#,IN,1 
ronczzzzzzzzzzzzzz	#,IN,1 
het	#,IN,1 
lovezin	#,IN,1 
monstra	#,IN,1 
poowww	#,IN,1 
rrrrrrrroubou	#,IN,1 
zoas	#,IN,1 
taoooo	#,IN,1 
tcd	#,IN,3 
twitadas	#,IN,1 
zoeirasssss	#,IN,1 
felizona	#,IN,1 
showzinho	#,IN,1 
jogabilidades	jogabilidade,IN,2 
muitoooooo	muito,IN,1 
brasilis	#,IN,1 
kcete	cacete,IN,1 
desinstalar	#,IN,1 
jega	#,IN,1 
adorooooo	#,IN,1 
boninhadas	#,IN,1 
cell	céu,IN,1 
dells	deus,IN,1 
muuiiiiiiiiiiiiiito	muito,IN,1 
amorzinho	amor,IN,1 
aviona	avião,IN,1 
mamy	mãe,IN,2 
minimo	menino,IN,1 
vesguinho	vesgo,IN,1 
amoooor	amor,IN,1 
comecinho	#,IN,1 
ahh	#,IN,2 
homao	#,IN,1 
tudinho	#,IN,1 
megas	#,IN,1 
buceta	#,IN,1 
descobreeeee	#,IN,1 
homi	homem,IN,1 
horrorrr	#,IN,1 
agoooora	agora,IN,1 
awn	#,IN,1 
fofinhosss	#,IN,1 
tadin	#,IN,1 
fofuchos	#,IN,1 
ham	#,IN,1 
ryca	#,IN,1 
sacoooooo	#,IN,1 
deuso	deus,IN,1 
novis	novidade,IN,1 
gravaaaaar	gravar,IN,1 
mimmmmm	mim,IN,1 
sabeeeee	sabe,IN,1 
vcccc	você,IN,2 
falsiane	falso,IN,1 
potaquiospariu	#,IN,1 
foraaaaaaaaaaaaaaaa	fora,IN,1 
adoruuuu	adoro,IN,1 
brigadaaaa	obrigada,IN,1 
hinooooo	hino,IN,1 
momis	mãe,IN,1 
ozamigo	#,IN,1 
surtadinho	louco,IN,1 
kra	cara,IN,1 
ameiiii	amei,IN,1 
maisssssssss	mais,IN,1 
moreee	amor,IN,1 
siiim	sim,IN,1 
maravilhosaaa	maravilhosa,IN,1 
opaaa	#,IN,1 
boladona	chateada,IN,1 
deuuus	deus,IN,1 
meuuuu	meu,IN,1 
serumaninho	#,IN,1 
vamoooooooooooo	vamos,IN,1 
cornetar	xingar,IN,2 
fuuuuii	fui,IN,1 
peguete	namorado,IN,1 
ahazo	arrasou,IN,1 
obrigaaddooo	obrigado,IN,1 
raba	nádegas,IN,1 
scrrrrr	socorro,IN,1 
boyzinho	menino,IN,1 
entaum	então,IN,1 
pepeca	vagina,IN,1 
massssss	mas,IN,1 
mew	meu,IN,1 
muuuuuuuito	muito,IN,1 
caraiiiii	caralho,IN,1 
problemaaaa	problema,IN,1 
pouquin	pouquinho,IN,1 
aaa	ah,IN,1 
legaall	legal,IN,1 
atee	até,IN,1 
dormiiiir	dormir,IN,1 
dormiir	dormir,IN,1 
ouu	ou,IN,1 
pensoo	penso,IN,1 
quandoo	quando,IN,1 
quintaa	quinta,IN,1 
raiaar	raiar,IN,1 
zap	whatsapp,IN,1 
lokas	loucas,IN,1 
buzanfam	buzanfão,IN,1 
marvada	malvada,IN,1 
flw	#,IN,1 
galeraaaa	#,IN,1 
heimmm	#,IN,1 
mlkedaaaa	#,IN,1 
picaaaaa	#,IN,1 
skaaaaate	#,IN,1 
amoresssss	amores,IN,1 
bosssssta	bosta,IN,1 
caraca	#,IN,1 
dmsss	demais,IN,1 
fodaaa	foda,IN,1 
acordouu	acordou,IN,1 
boaaa	boa,IN,1 
milionariaaaa	milionária,IN,1 
tardee	tarde,IN,1 
poem	põe,IN,1 
poha	porra,IN,1 
somemm	#,IN,1 
migaa	amiga,IN,1 
oii	oi,IN,1 
vcss	vocês,IN,1 
nadaaa	nada,IN,1 
tristeeeee	triste,IN,1 
seeeeeenhor	senhor,IN,1 
opps	ops,IN,1 
enlouqueeeeeece	enlouquece,IN,1 
montanhaa	montanha,IN,1 
boaaaaaaaaaaaaaaaaaaaaaaaaa	boa,IN,1 
millllllllll	mil,IN,1 
recomendoooo	recomendo,IN,1 
fodeeeer	foder,IN,1 
nariga	nariz,IN,1 
aaaaah	ah,IN,1 
